附件上海电子信息职业技术学院2022年度招聘计划（第一批次）	
二级部门	岗位	2022年 计划招聘数	招聘要求	专业及其他要求	
电子技术与工程学院	专任教师	20	1、应具有硕士及以上学位，获得博士研究生学历学位、或副高级及以上专业技术职务者优先；                               2、有相关高校从教经验或企业经历者优先。	应具备电子信息类、集成电路类、计算机类（嵌入式、人工智能工程、计算机应用）、自动化类（智能控制技术）、电子竞技运动与管理等相关专业背景。	
通信与信息工程学院	专任教师	57	应具备通信工程、软件技术、网络技术、计算机应用技术、大数据应用技术、智能控制、物联网、物理、应用数学等相关专业背景。	
机械与能源工程学院	专任教师	21	应具备智能机械及机器人、机器人与工业自动化、计算机科学与技术、机械电子工程、信息与通信工程、控制科学与工程、机械工程等相关专业背景。	
经济与管理学院	专任教师	17	应具备跨境电子商务、人力资源管理、会展旅游、金融管理、大数据与会计、互联网金融、大数据经济、智能营销、区块链应用等相关专业背景。	
中德工程学院	专任教师	10	应具备飞行器制造、飞行器控制、机械工程、表面工程、材料物理、控制科学与工程、电气工程、信息与通信工程、仪器科学与技术等相关专业，在工业互联网OT、工业数字化转型、智能制造、工业大数据等相关领域,有一定工作基础者优先。	
设计与艺术学院	专任教师	8	应具备数字媒体技术、数字媒体艺术、环境设计等相关专业背景。	
外语学院	专任教师	8	应具备德语、英语、教育学、跨文化、翻译技术等相关专业背景。	
公共基础学院	专任教师	5	应具备数学与应用数学、数学教育、汉语言文学、汉语国际教育等相关专业背景。	
马克思主义学院	专任教师	5	应具备哲学、思想政治教育、中共党史、马克思主义理论、马克思主义中国化等相关专业背景。	
申安网络安全产业学院	专任教师	5	应具备通信工程、软件技术、网络技术、计算机应用技术、大数据应用技术、智能控制、物联网、网络安全、密码学、物理、应用数学等相关专业背景。	
共计	156			
二级部门	岗位	2022年 计划招聘数	招聘要求	专业及其他要求	
学生工作部/学生处	辅导员	1	1、热爱学生工作，工作踏实、认真；具有良好的组织、沟通、协调能力；                             2、能够熟练应用各种办公软件；                             3、中共党员，专业不限，应具有硕士及以上学位，并达到全国大学生外语四级或以上水平；                             4、善于沟通，细致耐心；                             5、有相关高校辅导员经历者或学生管理工作经验者优先。	不限	
少数民族辅导员	1	1、中共党员（含预备党员）；                             2、具有全日制本科及以上学历，学士及以上学位；                             3、新疆籍少数民族，能够熟练使用维吾尔语和国家通用语言文字。	不限	
共计	2			
二级部门	岗位	2022年 计划招聘数	招聘要求	专业及其他要求	
党委办公室	干事	1	参见《招聘公告》中“招聘基本条件”	中共党员	
党委宣传部	新闻宣传办公室主任	1	中共党员	
宣传干事	1	中共党员	
纪检监察处	干事	1	中共党员	
党委教师工作部	干事	1	中共党员	
教务处	教务管理	1		
科研处	科研管理	1		
学报编辑	1		
综合档案馆	校史编纂	1		
资产管理处	资产管理	1		
后勤保卫处	工程资料与内勤管理	1		
通信与信息工程学院	科员	1		
电子技术与工程学院	教务管理办公室主任	1		
学生秘书	1		
中德工程学院	科员	1		
公共基础学院	教务秘书	1		
共计	16			
